c: 0x0060b8ff     # background color: [0xrrggbbaa]
b: 1              # background id: [1-10]
m: 1              # music id: [1-3]
/////////////////////////////////////////////////////////////////////////////////////////////////////////////////////////////////////////////////////////////////////////////////////////////////////////////////////////////////////////////////
/                                                                                                                                                                                                                                               /
/                                                                                                                                                                                                                                               /
/                                                                                                                                                                                                                                               /
/                                                                                                                                                                                                                                               /
/u                                                                                                                                                                               2                                                              /
/F                                                                                                                                                                                                                                              /
/D        K    K                                                                                                                                                                                                                                /
/D                        KKKKKKKK                                                                                                                                     2                      K          KKKKKKKKKKKKKKKK                   *   /
/D                                          KKKKKKKK                                                                                                                                                                   KKKKKKKK                 /
/D                                                 KKKKKK                                                                                                                                                                    KKKKKKKKKK         /
/D                                                      KKKKKKK                                                                                                                   IIII                                       KKKKKKKKKKEBBBBBBBB/
/D                                                            KKKKKKK                             o o o o o o o                                                                                         8                              CAAAAAAAA/
/D                                                                                                                            ST                                                                    8                                  CAAAAAAAA/
/D                                                             o o o o o o o    3                    5      5                YQRST                                      UV                       8                                     CAAAAAAAA/
/D                                                     IIIIIIIIIIIIIIIIIIIIIIIIIIII        KKKKKKKKKKKKKKKKKKKKKKKKKKK       ZQRQR    1   1                             WX                    8                                        CAAAAAAAA/
/D                                                 IIIIIIII                                          o            KKKKKKKKKKKKKKKKKKKKKKKKKKKKK                      1  WX                                                   ST o o o oCAAAAAAAA/
/D                                            IIIIIIII                                              o o                                                           EBBBBBBBBBBF                                               QRSTo o o CAAAAAAAA/
/D                          IIIIIIIIIIIIIIIIIIIIIII                     OP                         o o o                                2                      o  CAAAAAAAAAAD                                              YQRQR o o oCAAAAAAAA/
/D                                                                      MNOP                        o o                              o o o o                  o o CAAAAAAAAAAHBBBBBF                                        ZQRQRY o o CAAAAAAAA/
/D                                                     o o o            MNMN                         o                                                      EBBBBBGAAAAAAAAAAAAAAAAHBBBBBBF                                 ZQRQRZY o oCAAAAAAAA/
/D   p      o o o o             1        1            o o o o           MNMN                    4       4       4       4                                   CAAAAAAAAAAAAAAAAAAAAAAAAAAAAAHBF         3    4    5    6      ZQRQRZZo o CAAAAAAAA/
/HBBBBBBBBBBBBBBBBBBBBBBBBBBBBBBBBBBBBBBBBBBBBBBBBBBBBBBBBBBBBBBBBBBBBBBBBBBBBBBBBBBBBBBBBBBBBBBBBBBBBBBBBBBBBBBBBBBBBBBBBBBBBBBBBBBBBBBBBBBBBBBBBBBBBBBBBBBGAAAAAAAAAAAAAAAAAAAAAAAAAAAAAAAHBBBBBBBBBBBBBBBBBBBBBBBBBBBBBBBBBBBBBBBBBBGAAAAAAAA/
/AAAAAAAAAAAAAAAAAAAAAAAAAAAAAAAAAAAAAAAAAAAAAAAAAAAAAAAAAAAAAAAAAAAAAAAAAAAAAAAAAAAAAAAAAAAAAAAAAAAAAAAAAAAAAAAAAAAAAAAAAAAAAAAAAAAAAAAAAAAAAAAAAAAAAAAAAAAAAAAAAAAAAAAAAAAAAAAAAAAAAAAAAAAAAAAAAAAAAAAAAAAAAAAAAAAAAAAAAAAAAAAAAAAAAAAAAAAAAAA/