////////////////////////////////////////////////////////////////////////////////////////////////////////////////////////////////////////////////////////////////////////////////////////////////////////////////////////////////////////////////
/                                                                                                                                                                                                                                              / 
/             K o o o o o o o                                                                                                                                                                                                                  /
/             K  o o o o o o                                                                                                                                                                                                                   /
/             K o o o o o o o                                                                      I        I        I        I        I        I        I        I       II                                                                   /
/             K  o o o o o o  KKKKKKK                                    oo                                                                                               II                                                                 EB/
/             K6o o5o o4o o3o K     KKK                                 IIII          EBBF                                                                                 II          2                                                     CA/
/             KKKKKKKKKKKKKKKKK                             oo                        CAAD                                                               o                  II                    2                                          CA/
/                                                          IIII                       CAAD                                                              o o                  II                              2                               CA/
/BF                                            oo                                     CAAD                                                             o o o             o    II   o o o o o o o o o o o o o o                               CA/
/AD                                           IIII                                   ICAAD                                                            IIIIIII           o o    IIIIIIIIIIIIIIIIIIIIIIIIIIIIIIIIII                            CA/
/AD                                                                                   CAAD                 o                                                           o o o                I    K              EBBBBBBBBBBBBBF     o o o o  CA/
/AD                                                    oo                             CAAD                o o                                                         IIIIIII               I    K  *           CAAAAAAAAAAAAAD    o o o o o CA/
/AD                                                   IIII                           ICAAD               o o o                                                                     9        I    KKKKKKK        CAAAAAAAAAAAAAHF    o o o o  CA/
/AD           o                                oo                                     CAAD                o o                                                                           9              K        CAAAAAAAAAAAAAAD   o o o1o o CA/
/AD          o o             EBBBF            IIII                                    CAAD                 o                                                EBBBBBBF                                   KKKK   STCAAAAAAAAAAAAAAHF   IIIIIII  CA/
/AD         o o o            CAAAD                                                   ICAAD o            OPOPOPY                    o o o        EBBBBF      CAAAAAAD   @    @       IIIIIIIIIIIII             QRCAAAAAAAAAAAAAAAD  o o o o o CA/
/AD                          CAAAD         o        o         o            u          CAAD o ST         MNMNMNZY                 EBBBBBBBF      CAAAAD      CAAAAAAHBBBBBBBBBBBBF                             QRCAAAAAAAAAAAAAAAHF  o o o o  CA/
/AD   p                1     CAAAD        III      III       III          III         CAAD o QRY  7  7  MNMNMNZZY     %    %     CAAAAAAAD      CAAAAD      CAAAAAAAAAAAAAAAAAAAD      %     %     %       KKKKKCAAAAAAAAAAAAAAAAD o o1o o o CA/
/AHBBBBBBBF       EBBBBBBBBBBGAAAD                                                    CAAHBBBBBBBBBBBBBBBBBBBBBBBBBBBBBBBBBBBBBBBGAAAAAAAD      CAAAAD      CAAAAAAAAAAAAAAAAAAAHBBBBBBBBBBBBBBBBBBBBBBBBBBBBBBBGAAAAAAAAAAAAAAAAHBBBBBBBBBBBGA/
/AAAAAAAAAD       CAAAAAAAAAAAAAAD                                                    CAAAAAAAAAAAAAAAAAAAAAAAAAAAAAAAAAAAAAAAAAAAAAAAAAAD      CAAAAD      CAAAAAAAAAAAAAAAAAAAAAAAAAAAAAAAAAAAAAAAAAAAAAAAAAAAAAAAAAAAAAAAAAAAAAAAAAAAAAAAAAA/